╔═══════╦═══════╦═══════════════╦════════╗
║       ║       ║               ║        ║
║   @   ║       ║               ║        ║
║               ║               ║        ║
║                               ║        ║
║       ║                                ║
║       ╚═══════════════╗                ║
║   ║                   ║                ║
╠═══╬═══    ╔═══════╗   ╠══════   ══╦════╣
║   ║       ║       ║   ║           ║    ║
║           ║   ════╝   ║           ║    ║
║           ║           ║           ║    ║
║           ╚═══  ══════╣           ║    ║
║                               ║   ║    ║
║                               ║   ║    ║
╠═══════════════════════╝       ║        ║
║                               ║        ║
║       ╔═══════    ════════════╣        ║
║       ║                                ║
╚═══════╩═══════════════════════╩════════╝
